1111111111111111111111111111111111111111111111111111111111111111111111111111111111111111111111111111
1FFFFFFFFFF222222221FFFFFFFFFFFFFFFFFFFFF100000000000000000000000000122222222222222222222221FFFFFFF1
1FFFFFFFFFF222222221FFFFFFFFFFFFFFFFFFFFF100000000000000000000000000122222222222222222222221FFFFFFF1
1FFFFFFFFFF222222221FFFFFFFFFFFFFFFFFFFFF100000000000000000000000000122222222222222222222221FFFFFFF1
1FFFFFFFFFF111111111FFFFFFFFFFFFFFFFFFFFF100000000000000000000000000122221222222222222222221FFFFFFF1
1FFFFFFFFFF222222221FFFFFFTTTTTTTTTTFFFFF100000000000000000000000000122221222222222222222221FFFFFFF1
1FFFFFFFFFF222222221FFFFFFTTTTTTTTTTFFFFF1000000000000000000000000001222212211D1111111122211FFFFFFF1
1FFFFFFFFFF222222221FFFFFFTTTTTTTTTTFFFFF100000000000000000000000000122221221221222222222221FFFFFFF1
1FFFFFFFFFF222222221FFFFFFFFFFFFFFFFFFFFF100000000000000000000000000122221221221222222222221FFFFFFF1
1FFFF111111111111111FFFFFFFFFFFFFFFFFFFFF100000000000000000000000000122221211221222222222221FFFFFFF1
1FFFFFFFFFFFFFFFFFFFFFFFFFFFFFFFFFFFFFFFF100000000000000000000000000122221112221122222222221FFFFFFF1
1FFFFFFFFFFFFFFFFFFFFFFFFFFFFFFFFFFFFFFFF100000000000000000000000000122222122222111222222221FFFFFFF1
1FFFFFFFFFFFFFFFFFFFFFFFFFFFFFFFFFFFFFFFF100000000000000000000000000122222122222221222222221FFFFFFF1
1FFFFFTTTFFFFFFFFFFFFFFFFFFFFFFFFFFFFFFFF100000000000000000000000000122222122222221222222221FFFFFFF1
1FFFFFTTTFFFFFFFFFFFFFF11111111111111111D10000000000BBB00000000000001222221222222211D1111111FFFFFFF1
1FFFFFTTTFFFFFFFFFFFFFF122222220000000000000000000BBBBBB000000000000111111122222221222212221FFFFFFF1
1FFFFFTTTFFFFFFFFFFFFFF12222222000000000000000000BBBBBBB000000000000122222D2222222122221222DFFFFFFF1
1FFFFFTTTFFFFFFFFFFFPFF1222222200000000000000000BBBBBBBB000000000000122222111122221222212221FFFFFFF1
1FFFFFTTTFFFFFFFFFFFFFF1222222200000000000000000BBBBBBBBB00000000000122222122122221222212221FFFFFFF1
1FFFFFTTTFFFFFFFFFFFFFF1222222200000000000000000BBBBBBBBB00000000000122222122122221222212221FFFFFFF1
1FFFFFTTTFFFFFF11111111122222220000000000000000BBBBBBBBBBBSSSS000000122222122122221222212221FFFFFFF1
1FFFFFTTTFFFFFF12222222222222200000000000000000BBBBBBBBBBBBSSSS00000122222122122221222212221FFFFFFF1
1FFFFFFFFFFFFFF1222222222222220000000000000000BBBBBBBBBBBBBBBSSSS00011111D122111111222212221FFFFFFF1
1FFFFFFFFFFFFFF1222222222222220000000000000000BBBBBBBBBBBBBBBSSSS000122222122222222222212221FFFFFFF1
1FFFFFFFFFFFFFF122222222222222000000000000000BBBBBBBBBBBBBBBBSSSS000122222122222222222212221FFFFFFF1
1D1111111111111122220002222000000000000000000BBBBBBBBBBBBBBBBSSSS000122222122222211111112221FFFFFFF1
100000000000000000000000000000000000000000000BBBBBBBBBBBBBBBBSSSS000122222122222212222222221FFFFFFF1
10000000000000000000000000000000000000000000BBBBBBBBBBBBBBBBBSSSS0001222221222222D2222222221FFFFFFF1
10000000000000000000000000000000000000000000BBBBBBBBBBBBBBBBSSSSS0001D1111111111111111111111FFFFFFF1
10000000000000000000000000000000000000000000BBBBBBBBBBBBBBBBSSSSS000000000000000000000000001FFFFFFF1
10000000000000000000000000000000000000000000BBBBBBBBBBBBBBBBSSSSS000000000000000000000000001FFFFFFF1
100000000000000000000000000000000000000000000BBBBBBBBBBBBBBSSSSSS000000000000000000000000001FFFFFFF1
10000000000000000000000000000000000BBB0000000BBBBBBBBBBBBBBSSSSSS000000000000000000000000001FFFFFFF1
100000000000000000000000000000000BBBBB0000000BBBBBBBBBBBBBBSSSSSS000000000000000000000000001FFFFFFF1
100000000000000000000000000000000BBBBB0000000BBBBBBBBBBBBBBSS0000000000000000000000000000001FFFFFFF1
10000000000000000000000000000000BBBBB00000000BBBBBBBBBBBBBBSS0000000000000000000000000000001FFFFFFF1
10000000000000000000000000000000BBBB00000000BBBBBBBBBBBBBBBSS0000000000000000000000000000001FFFFFFF1
10000000000000000000000000000000BBB000000000BBBBBBBBBBBBBBBSS0000000000000000000000000000001FFFFFFF1
10000000000000000000000000000000BBB0000000000BBBBBBBBBBBBB0000000000000000000000000000000001FFFFFFF1
1000000000000000000BBBBB00000000BBB000000000000BBBBBBBBBB000000000000A0000000000000000000001FFFFFFF1
10000000000000000BBBBBBB00000000BB0000000000000000BBBBBBB00000000000000000000000000000000001FFFFFFF1
100000000000BBBBBBBBBBBB0000000000000000000000000000BBBB000000000000000000000000000000000001FFFFFFF1
100000000000BBBBBBBBBBBB00000000000000000000000000000000000000000000000000000000000000000001FFFFFFF1
100000000000000000BBBBB000000000000000000000000000000000000000000000000000000000000000000001FFFFFFF1
10000000000000000000000000000000000000000000000000000000000000000000000000000000000000000001FFFFFFF1
10000000000000000000000000000000000000000000000000000000000000000000000000000000000000000001FFFFFFF1
10000000000000000000000000000000000000000000000000000000000000000000000000000000000000000001FFFFFFF1
10000000000000000000000000000000000000000000000000000000000000000000000000000000000000000001FFFFFFF1
10000000000000000000000000000000000000000000000000000000000000000000000000000000000000000001FFFFFFF1
10000000000000000000000000000000000000000000000000000000000000000000000000000000000000000001FFFFFFF1
10000000000000000000000000000000000000000000000000000000000000000000000000000000000000000001FFFFFFF1
10000000000000000000000000000000000000000000000000000000000000000000000000000000000000000001FFFFFFF1
10000000000000000000000000000000000000000000000000000000000000000000000000000000000000000001FFFFFFF1
10000000000000000000000000000000000000000000000000000000000000000000000000000000000000000001FFFFFFF1
10000000000000000000000000000000000000000000000000000000000000000000000000000000000000000001FFFFFFF1
10000000000000000000000000000000000000000000000000000000000000000000000000000000000000000001FFFFFFF1
10000000000000000000000000000000000000000000000000000000000000000000000000000000000000000001FFFFFFF1
10000000000000000000000000000000000000000000000000000000000000000000000000000000000000000001FFFFFFF1
10000000000000000000000000000000000000000000000000000000000000000000000000000000000000000001FFFFFFF1
10000000000000000000000000000000000000000000000000000000000000000000000000000000000000000001FFFFFFF1
1111111111111111111111111111111111111111111111111111111111111111111111111111111111111111111111111111
